#IABIN Controlled Subject Terms from NBII Biocomplexity Thesaurus
apicultura=>Apiculture
insectos=>Insects
polen,Pollen=>polinización
polinización cruzada=>Pollination,Cross-pollination,Artificial pollination 
entomofilia=>Insect pollination 
polinizadores=>Pollinators
polinizadoresalternativos=>Alternative pollinators,non-Apis pollinators
insectos polinizadores=>Pollinating insects
agua de lastre=>Ballast water
aptitud colonizadora=>Colonizing ability
exclusión competitiva=>Competitive exclusion
especies introducidas=>Introduced species
plantas introducidas=>Introduced plants
animales introducidas=>Introduced animals
especies invasivas=>Invasive species
Plantas invasivas=>Invasive plants
animales invasivas=>Invasive animals
animales=>Animals
invertebrados=>Invertebrates
artrópodos, artropodos=>Arthropods
lombrices de tierra=>Earthworms	      
moluscos=> Mollusks
vertebrados=>Vertebrates
anfibios=>Amphibians
aves (animales)=>Birds
aves de presa=>Raptors
aves acuáticas de cazería=>Waterfowl
peces=>Fishes,Freshwater fishes,Marine fishes
mamíferos=>Mammals
mamíferos marinos=>Marine mammals
reptiles=>Reptiles
especies=>Species
especies en peligro de extinción=>Endangered species,Candidate species
especies indicadoras=>Indicator species
especies nativas=>Indigenous species
especies claves=>Keystone species
especies protegidas=>Protected species
diversidad de especies=>Species diversity
taxonomía=>Taxonomy
colecciones de tipos=>Type specimens, voucher specimens
herbarios=>Herbaria
ecosistemas=>Ecosystems
Ecosistemas estuarinos=>Estuarine ecosystems
Ecosistemas marinas=>Marine ecosystems
ecosistemas forestales=>Forest ecosystems
agroescosistemas=>Agricultural ecosystems
Ecosistemas costeras=>Coastal ecosystems
manejo de ecosistemas=>Ecosystem management
servicios de ecosistemas=>Ecosystem services*
hábitats=>Habitats
desiertos=>Deserts
desertificación=>Desertification
bosques=>Forests
bosques costeros=>Coastal forests
bosques de coníferas=>Coniferous forests
bosques caducifolios=>Deciduous forests
bosques secos=>Dry forests
bosques primarios pristinos=>Old growth [forests] (change)
bosques primarios=>Primary forests
bosques lluviosos=>Rain forests
bosques ripícolas=>Riparian forests
bosques secundarios=>Secondary forests
bosques templados=>Temperate forests
bosques tropicales=>Tropical forests
corta a hecho=>Clearcutting
deforestación=>Deforestation
biomasa=>Forest biomass
llanuras,pastos=>Grasslands
campos=>Fields
estepas=>Meadows
tierras de pastoreo=>Pastures
praderas=>Prairies
tierras de pasto=>Rangelands
sabanas=>Savannas
áreas arbustivas=>Scrub
tundra=>Tundra
humedales=>Wetlands
ciénagas=>Bogs
humedales construidos=>Artificial wetlands
fens=> Fens
marismas=>Marshes
turberas=>Peatlands
tierras húmedas estacionales=>Seasonal wetlands
pantanos=>Swamps
agricultura sustentable=>Sustainable agriculture
desarrollo sustentable=>Sustainable development
silvicultura sustentable=>Sustainable forestry*
rendimiento sostenido=>Sustainable yield
Areas protegidas=>Protected Areas
parques=>Parks
parques nacionales=>National parks
biogeografía=>Biogeography
cartografía=>Cartography
bases de datos=>Databases
Sistema de Observación de la Tierra=>Earth Observing System
radiación electromagnética=>Electromagnetic radiation
sistemas de información geográfica=>Geographic information systems
sistema de coordenadas geográficas=>Geographical coordinates
latitud=>Latitude
longitud=>Longitude
distribución geográfica=>Geographical distribution
geografía=>Geography
tecnología geoespacial=>Geospatial technology
sistemas de posicionamiento global=>Global positioning systems
imaginería hiperespectral=>Hyperspectral imagery
landsat=>Landsat
lásers=>Lasers
lidar=>Lidar
proyecciones geográficas=>Map projections
fotogrametría=>Photogrammetry
radar=>Radar
teledetección=>Remote sensing    
satélites=>Satellites
sensores=>Sensors
sonar=>Sonar
datos espaciales=>Spatial data
datos de ráster=>Raster data
datos vector=>Vector data
distribución espacial=>Spatial distribution
telemetría=>Telemetry